NO sprites/coin.xpm
SO sprites/floor.xpm


F 245,245,-10

C 119,181,254

WE sprites/wall.xpm
EA sprites/grass.xpm

111111111111111111111111
100000000000000000000001
100000000000E00000000001
100000000000000000000001
100000111110000101010001
100000100010000000000001
100000100010000100010001
100000100010000000000001
100000110110000101010001
100000000000000000000001
100000000000000000000001
100000000000000000000001
100000000000000000000001
100000000000000000000001
100000000000000000000001
100000000000000000000001
111111111000000000001111
1101000010000000000011
110000101000000000001111
110100001000000000000001
110111111000000000000001
110000000000000000000001
111111111000000000011111
111    111111111111111